#####     *       #######
        *.  1           #
    R   *         #     #
#          D D    # ### #
 #        * ####### ###
 ### ### ###            #
#         *D    .       #
              R          
### ####### ######  D####
#          * *          #
#             .R   *    #
####### #### ## #########

#           C           #
            .            

###### ##### #### #######