#####             #######
            1           #
                  #     #
#                 ##### #
##          ###########
############            #
#                       #
#########################