#####     *       #######
         .  1  WWWW  W  #
    R         H   #    B#
#       B  D      # ###h#
 #        * ####### ###
 ### ### ###            #

####### #### ## #########

#           C           #
            .            
###### ##### #### #######