#####     *       #######
        *.  1           #
        *         #     #
#          D D    ##### #
##        * ###########
############            #
#         *D    .       #
#                       #
##################  D####
#          * *          #
#             .    *    #
############D############