#####     *       #######
     EE  .  1  WWWW  W  #
    R O  RRB  H   #    B#
#       B  D      # ###h#
 #    K   * ####### ###
#### ### ###            #

####### #### ## #########

#          K K    N     #
            .            
###### ##### #### #######