#####     *       #######
     EE  .  1  WWWW  W  #
    R O    B  H   #    B#
#       B  D      # ###h#
 #        * ####### ###
#### ### ###            #

####### #### ## #########

#           C     N     #
            .            
###### ##### #### #######