#####             #######
            1           #
                  #     #
#                 ##### #
##          ###########
############            #
#                       #
#                       #
###########   ###########
#                       #
#                       #
##################   ####
#                       #
#                       #
###   ###################
#                       #
#                       #
############ ############