#####     *       #######
        *.  1       * D #
        *         #   D #
#                 ##### #
################# ##### #